111111111111111111
10000CE000000000C1
11111110C000000001
100000000000P0C001
100000000000000001
111111111111111111
