111111111111111111
1000EC0000000000C1
11111110C000000001
100000000000P0C001
100000000000000001
111111111111111111
