11111111111111111
10000C0000000000E1
100000000000000001
10000P00000000C001
100000000000000001
111111111111111111
