111111111111111111111111111111
100P0C0000000000000000000000E1
10000000C000000000000000000001
10000000000000C000000000000F01
111111111111111111111111111111
