111111111111111111111111111111
10000C000000000000000000F000E1
10000000C000000000000000000001
100000000000P0C000000000000001
111111111111111111111111111111
